player = '@'
box = 'o'
empty_space = '.'
enemy = '>'
destination = 'X'
wall = '#'
door = 'D'
bullet = '*'
game
########################
#................o.....#
#...............#......#
#...>...*...@...#......#
#...............#......D
#..X............#......#
#......................#
########################